{
    "map":[
        {"row": ["0","2","0","2","0","2","0","2","0","2","0","2","0","2","0","2","0","2","0","2","0","2","0","2","0"]},
        {"row": ["1","3","1","3","1","3","1","3","1","3","1","3","1","3","1","3","1","3","1","3","1","3","1","3","1"]},
        {"row": ["0","2","0","2","0","2","0","2","0","2","0","2","0","2","0","2","0","2","0","2","0","2","0","2","0"]},
        {"row": ["1","3","1","4","1","3","1","3","1","3","1","3","1","3","1","3","1","3","1","3","1","3","1","3","1"]},
        {"row": ["0","2","0","2","0","2","0","2","0","2","0","2","0","2","0","2","0","2","0","2","0","2","0","2","0"]},
        {"row": ["1","3","1","3","1","3","1","3","1","3","1","3","1","3","1","3","1","3","1","3","1","3","1","3","1"]},
        {"row": ["0","2","0","2","0","2","0","2","0","2","0","2","0","2","0","2","0","2","0","2","0","2","0","2","0"]},
        {"row": ["1","3","1","3","1","4","1","3","1","3","1","3","1","3","1","3","1","3","1","3","1","3","1","3","1"]},
        {"row": ["0","2","0","2","0","2","0","2","0","2","0","2","0","2","0","2","0","2","0","2","0","2","0","2","0"]},
        {"row": ["1","3","1","3","1","3","1","3","1","3","1","3","1","3","1","3","1","3","1","3","1","3","1","3","1"]},
        {"row": ["0","2","0","2","0","2","0","2","0","2","0","2","0","2","0","2","0","2","0","2","0","2","0","2","0"]},
        {"row": ["1","3","1","3","1","3","1","3","1","3","0","0","0","0","0","0","1","3","1","3","1","3","1","3","1"]},
        {"row": ["0","2","0","2","0","2","0","2","0","2","0","2","0","2","0","2","0","2","0","2","0","2","0","2","0"]},
        {"row": ["1","3","1","3","1","3","1","3","1","3","1","3","1","3","1","3","1","3","1","4","1","3","1","3","1"]},
        {"row": ["0","2","0","2","0","2","0","2","0","2","0","2","0","2","0","2","0","2","0","2","0","2","0","2","0"]},
        {"row": ["1","3","1","3","1","3","1","3","1","3","1","3","1","3","1","3","1","3","1","3","1","3","1","3","1"]},
        {"row": ["0","2","0","2","0","2","0","2","0","2","0","2","0","2","0","2","0","2","0","2","0","2","0","2","0"]},
        {"row": ["1","3","1","0","0","5","0","0","1","3","1","3","1","3","1","4","1","3","1","3","1","3","1","3","1"]},
        {"row": ["0","2","0","2","0","2","0","2","0","2","0","2","0","2","0","2","0","2","0","2","0","2","0","2","0"]},
        {"row": ["1","3","1","3","1","3","1","3","1","3","1","3","1","3","1","3","1","3","1","3","1","3","1","3","1"]},
        {"row": ["0","2","0","2","0","2","0","2","0","2","0","2","0","2","0","2","0","2","0","2","0","2","0","2","0"]},
        {"row": ["1","3","1","3","1","3","1","3","1","3","1","3","1","3","1","3","1","3","1","3","1","3","1","3","1"]},
        {"row": ["0","2","0","2","0","2","0","2","0","2","0","2","0","2","0","2","0","2","0","2","0","2","0","2","0"]},
        {"row": ["1","3","1","3","1","3","1","3","1","3","1","3","1","3","1","3","1","3","1","3","1","3","1","3","1"]},
        {"row": ["0","2","0","2","0","2","0","2","0","2","0","2","0","2","0","2","0","2","0","2","0","2","0","2","0"]}
    ]
}


/*Mapa Plantilla

    "map":[
        {"row": ["0","2","0","2","0","2","0","2","0","2","0","2","0","2","0","2","0","2","0","2","0","2","0","2","0"]},
        {"row": ["1","3","1","3","1","3","1","3","1","3","1","3","1","3","1","3","1","3","1","3","1","3","1","3","1"]},
        {"row": ["0","2","0","2","0","2","0","2","0","2","0","2","0","2","0","2","0","2","0","2","0","2","0","2","0"]},
        {"row": ["1","3","1","3","1","3","1","3","1","3","1","3","1","3","1","3","1","3","1","3","1","3","1","3","1"]},
        {"row": ["0","2","0","2","0","2","0","2","0","2","0","2","0","2","0","2","0","2","0","2","0","2","0","2","0"]},
        {"row": ["1","3","1","3","1","3","1","3","1","3","1","3","1","3","1","3","1","3","1","3","1","3","1","3","1"]},
        {"row": ["0","2","0","2","0","2","0","2","0","2","0","2","0","2","0","2","0","2","0","2","0","2","0","2","0"]},
        {"row": ["1","3","1","3","1","3","1","3","1","3","1","3","1","3","1","3","1","3","1","3","1","3","1","3","1"]},
        {"row": ["0","2","0","2","0","2","0","2","0","2","0","2","0","2","0","2","0","2","0","2","0","2","0","2","0"]},
        {"row": ["1","3","1","3","1","3","1","3","1","3","1","3","1","3","1","3","1","3","1","3","1","3","1","3","1"]},
        {"row": ["0","2","0","2","0","2","0","2","0","2","0","2","0","2","0","2","0","2","0","2","0","2","0","2","0"]},
        {"row": ["1","3","1","3","1","3","1","3","1","3","0","0","0","0","0","0","1","3","1","3","1","3","1","3","1"]},
        {"row": ["0","2","0","2","0","2","0","2","0","2","0","2","0","2","0","2","0","2","0","2","0","2","0","2","0"]},
        {"row": ["1","3","1","3","1","3","1","3","1","3","1","3","1","3","1","3","1","3","1","3","1","3","1","3","1"]},
        {"row": ["0","2","0","2","0","2","0","2","0","2","0","2","0","2","0","2","0","2","0","2","0","2","0","2","0"]},
        {"row": ["1","3","1","3","1","3","1","3","1","3","1","3","1","3","1","3","1","3","1","3","1","3","1","3","1"]},
        {"row": ["0","2","0","2","0","2","0","2","0","2","0","2","0","2","0","2","0","2","0","2","0","2","0","2","0"]},
        {"row": ["1","3","1","3","1","3","1","3","1","3","1","3","1","3","1","3","1","3","1","3","1","3","1","3","1"]},
        {"row": ["0","2","0","2","0","2","0","2","0","2","0","2","0","2","0","2","0","2","0","2","0","2","0","2","0"]},
        {"row": ["1","3","1","3","1","3","1","3","1","3","1","3","1","3","1","3","1","3","1","3","1","3","1","3","1"]},
        {"row": ["0","2","0","2","0","2","0","2","0","2","0","2","0","2","0","2","0","2","0","2","0","2","0","2","0"]},
        {"row": ["1","3","1","3","1","3","1","3","1","3","1","3","1","3","1","3","1","3","1","3","1","3","1","3","1"]},
        {"row": ["0","2","0","2","0","2","0","2","0","2","0","2","0","2","0","2","0","2","0","2","0","2","0","2","0"]},
        {"row": ["1","3","1","3","1","3","1","3","1","3","1","3","1","3","1","3","1","3","1","3","1","3","1","3","1"]},
        {"row": ["0","2","0","2","0","2","0","2","0","2","0","2","0","2","0","2","0","2","0","2","0","2","0","2","0"]}
    ]

*/