{
    "map":[
        {"row": ["0","0","0","2","0","2","0","2","0","2","0","2","0","2","0","2","0","2","0","2","0","2","0","2","0"]},
        {"row": ["1","3","1","3","1","3","1","3","1","3","1","3","1","3","1","3","1","3","1","3","1","3","1","3","1"]},
        {"row": ["0","2","0","2","0","2","0","2","0","2","0","2","0","2","0","2","0","2","0","2","0","2","0","2","0"]},
        {"row": ["1","3","1","3","1","3","1","3","1","3","1","3","1","3","1","3","1","3","1","3","1","3","1","3","1"]},
        {"row": ["0","2","0","2","0","2","0","2","0","2","0","2","0","2","0","2","0","2","0","2","0","2","0","2","0"]},
        {"row": ["1","3","1","3","1","3","1","3","1","3","1","3","1","3","1","3","1","3","1","3","1","3","1","3","1"]},
        {"row": ["0","2","0","2","0","2","0","2","0","2","0","2","0","2","0","2","0","2","0","2","0","2","0","2","0"]},
        {"row": ["1","3","1","3","1","3","1","3","1","3","1","3","1","3","1","3","1","3","1","3","1","3","1","3","1"]},
        {"row": ["0","2","0","2","0","2","0","2","0","2","0","2","0","2","0","2","0","2","0","2","0","2","0","2","0"]},
        {"row": ["1","3","1","3","1","3","1","3","1","3","1","3","1","3","1","3","1","3","1","3","1","3","1","3","1"]},
        {"row": ["0","2","0","2","0","2","0","2","0","2","0","2","0","2","0","2","0","2","0","2","0","2","0","2","0"]},
        {"row": ["1","3","1","3","1","3","1","3","1","3","1","3","1","3","1","3","1","3","1","3","1","3","1","3","1"]},
        {"row": ["0","2","0","2","0","2","0","2","0","2","0","2","0","2","0","2","0","2","0","2","0","2","0","2","0"]},
        {"row": ["1","3","1","3","1","3","1","3","1","3","1","3","1","3","1","3","1","3","1","3","1","3","1","3","1"]},
        {"row": ["0","2","0","2","0","2","0","2","0","2","0","2","0","2","0","2","0","2","0","2","0","2","0","2","0"]},
        {"row": ["1","3","1","3","1","3","1","3","1","3","1","3","1","3","1","3","1","3","1","3","1","3","1","3","1"]},
        {"row": ["0","2","0","2","0","2","0","2","0","2","0","2","0","2","0","2","0","2","0","2","0","2","0","2","0"]},
        {"row": ["1","3","1","3","1","3","1","3","1","3","1","3","1","3","1","3","1","3","1","3","1","3","1","3","1"]},
        {"row": ["0","2","0","2","0","2","0","2","0","2","0","2","0","2","0","2","0","2","0","2","0","2","0","2","0"]},
        {"row": ["1","3","1","3","1","3","1","3","1","3","1","3","1","3","1","3","1","3","1","3","1","3","1","3","1"]},
        {"row": ["0","2","0","2","0","2","0","2","0","2","0","2","0","2","0","2","0","2","0","2","0","2","0","2","0"]},
        {"row": ["1","3","1","3","1","3","1","3","1","3","1","3","1","3","1","3","1","3","1","3","1","3","1","3","1"]},
        {"row": ["0","2","0","2","0","2","0","2","0","2","0","2","0","2","0","2","0","2","0","2","0","2","0","2","0"]},
        {"row": ["1","3","1","3","1","3","1","3","1","3","1","3","1","3","1","3","1","3","1","3","1","3","1","3","1"]},
        {"row": ["0","2","0","2","0","2","0","2","0","2","0","2","0","2","0","2","0","2","0","2","0","2","0","2","0"]}
    ]
}